...........................................
.#########################################.
.#....#..#.......#...............#.......#.
.#.......#.......#...............#......##.
.#.......#.......#...............#.......#.
.######..######..#..######..########..####.
.#.......................................#.
.#.......................................#.
.#.......................................#.
.#..######..###########..##############..#.
.#.......#.......#..#.........#..........#.
.#.......##......#..#.....#...#..........#.
.#.......#.......#........#...#..........#.
.#########################################.
...........................................