......................
.####################.
.#...#....#......#..#.
.#...#....#......#..#.
.#...#....#......#..#.
.#...#....#####.....#.
.#...#....#.........#.
.#........#......####.
.#........#.........#.
.####..###########..#.
.#..#...............#.
.#..#...............#.
.#..#...............#.
.#..#...............#.
.#..#..####..########.
.#........#.....#...#.
.#........#.....#...#.
.#.....####.....#...#.
.#........#.....#...#.
.#........#.........#.
.####################.
......................
