......................
.####################.
.#....#.............#.
.#....#.............#.
.#....#........#....#.
.#.............######.
.#........######....#.
.#.............#....#.
.#..................#.
.#....#.............#.
.######........#....#.
.#....#........######.
.#....#..#######....#.
.#....#.....#..#....#.
.#....#.....#..#....#.
.#..........#.......#.
.#..................#.
.#.............######.
.#....#........#....#.
.#....#........#....#.
.######........#....#.
.#....#........#....#.
.#....#.............#.
.#....#.............#.
.#....#........#....#.
.#....###....###....#.
.#....#........#....#.
.#.............#....#.
.#.............######.
.#.............#....#.
.#....#...#....#....#.
.#....#...#....#....#.
.##..########..#....#.
.#........#....#....#.
.#........#.........#.
.#........#.........#.
.#....#####....######.
.#........#.........#.
.#........#.........#.
.#........#.........#.
.####################.
......................
