.................
.###############.
.#....#........#.
.#....#........#.
.#..........####.
.#.............#.
.########......#.
.#..........#..#.
.#..........#..#.
.#..........#..#.
.#....##########.
.#.....#....#..#.
.#.....#....#..#.
.#..........#..#.
.####.......#..#.
.#..........#..#.
.#..........#..#.
.#.............#.
.####..........#.
.#.............#.
.#.............#.
.#.........#####.
.########......#.
.#.............#.
.#.............#.
.#.....#########.
.#.............#.
.#.............#.
.#..#......#...#.
.#..#......#...#.
.###############.
.................
