................................
.##############################.
.#..#....#.....#.........#....#.
.#..#....#.....#.........#....#.
.#.......#.....#....#....#....#.
.#.......#.....#....#....#....#.
.####..###..##########..####..#.
.#............................#.
.#............................#.
.#............................#.
.#............................#.
.####..######..########..######.
.#..........#.........#.......#.
.#..........#.........#.......#.
.#..#..#....#.........#.......#.
.##############################.
................................
