................................
.##############################.
.#..#....#.........#....#.....#.
.#..#....#.........#....#.....#.
.#.......#.........#..........#.
.#.......#.........#..........#.
.######..####..#############..#.
.#....#...#.....#.......#.....#.
.#....#...#.....#.......#.....#.
.#....#...#.....#.......#.....#.
.###..#...#.....######..#.....#.
.#....#...#.........#.........#.
.#....#...#.........#.......###.
.###......#####.....#.........#.
.#........#.........#.........#.
.#.....................#......#.
.######................#..#...#.
.#.....................#..#...#.
.#.....................#..#...#.
.#.....................########.
.###..#......#................#.
.#....#......#................#.
.#....#......#................#.
.###..###..########...######..#.
.#....#.......#.......#.......#.
.#....#.......#.......#.......#.
.#....#.....###.......#.......#.
.###..###.....#.......####....#.
.#....#.......#....#..#.......#.
.#....#....#..#....#..#.......#.
.##############################.
................................
