..........................................
.########################################.
.#...#....#.........#..#....#.....#.....#.
.#...#....#.........#..#....#.....#.....#.
.#...#....#.........#..#....#.....#.....#.
.#...#....####......#.......#.....#.....#.
.#........#.........#....####.....#.....#.
.#........#.........#.......#...........#.
.#........#.........#.......#...........#.
.#######..####..#######..#########...####.
.#...#....#.......#..........#...#......#.
.#...#....#.......#..........#...#......#.
.#...#....#.......#..........#...#......#.
.#........#.......#..............#......#.
.#........#.......#..............#......#.
.#######..#.............................#.
.#.....#..#.............................#.
.#.....#..###########...................#.
.#.....#..#.............................#.
.#.....#..#......................#..#####.
.####..#.........................#......#.
.#..#..#.........................#......#.
.#..#..#..#......................#......#.
.#..#..#..#.................######......#.
.#..#..#..#......................#..#####.
.#..#.....#......................#......#.
.#..#.....##########.............#......#.
.#........#........#........######......#.
.#.....#..#......................#..#####.
.#.....#..#......................#......#.
.#.....#..#......................#......#.
.#.....#..#........#.............#......#.
.#.....#..#........#.............#......#.
.#.....#..############...######..########.
.####..#..#......#........#.............#.
.#.....#..#......#........#.............#.
.#.....#..#......#........#....#######..#.
.#.....#..#...#######.....#........#....#.
.#.....#..#...............#........#....#.
.#.....#..#...............#........#....#.
.########################################.
..........................................
