..........................................
.########################################.
.#..........#......#......#.......#.....#.
.#..........#......#......#.......#.....#.
.#....#.....#......#......#.......#.....#.
.#....#.....#.............#.......#.....#.
.#....#.....#.............#.............#.
.#..#########..#######################..#.
.#......#.....................#.........#.
.#......#...............................#.
.#......#...............................#.
.#............................#.........#.
.#............................#.........#.
.#............................#.........#.
.#..#####################..##########...#.
.#..........#..#...........#............#.
.#..........#..#...........#............#.
.#......#####..#.....#.....####.........#.
.#..........#........#.....#........#...#.
.#..........#........#.....#........#...#.
.########################################.
..........................................
